NO ./assets/texture/txtr1.xpm
SO ./assets/texture/txtr28.xpm
WE ./assets/texture/txtr10.xpm
EA ./assets/texture/txtr19.xpm

F 132,192,0
C 195,224,13

1111111111111111111
1010010010010000011
10110000010001111111
1001001001111110111
100111100000100111111
1000000000000001N01
1001111111111001001
1111000000000001011
1000000001000000001
1111111111111111111

