NO ./asset/texture/txtr1.xpm
SO ./asset/texture/txtr4.xpm
WE ./asset/texture/txtr10.xpm
EA ./asset/texture/txtr19.xpm

F 132,192,17
C 195,224,244

        1111111111111111111111111
        1000000000110000000000001
        10S1000001110000000000001
        1001000000000000000000001
111111111011000001110000000100001
100000000011000001110111110111111
11110111111111011100000010001
111111111111111111111111111111
                           
                           
                           
11111111111111111111111111111111
10000000000000000000000000000001
10000000000000000000000000000001
10000000000000000000000000000001
10000000000000000000000000000001
10000000000000000000000000000001
10000000000000000000000000000001
11111111111111111111111111111111