NO ./assets/texture/txtr1.xpm
SO ./assets/texture/txtr28.xpm
WE ./assets/texture/txtr10.xpm
EA ./assets/texture/txtr19.xpm

F 132,192,17
C 255,255,255

        1111111111111111111111111
        1000000000110000000000001
        1001000001110000000000001
        1001000000000000000000001
111111111011B0BB001110000000100001
10000000001100000111B11111D111111
111101111111N1011100000010001
111111111111D11111111111111111
           101
           101
           101
111111111111D1111111111111111111
100000000000000000000B0000000001
10000001000000000000000000000001
1000000D00000000000B000000000001
10000001000000000000000000000001
100000000000000B0000000000000001
11111111111101111111111111111111
111111111111D11111111111111111
           101
           101
           101
111111111111D1111111111111111111
10000000000000000000000000000001
10000001000000000000000000000001
1000000D000000000000000000000001
10000001000000000000000000000001
10000000000000000000000000000001
11111111111111111111111111111111
11111111111101111111111111111111
111111111111D11111111111111111
           101
           101
           101
111111111111D1111111111111111111
10000000000000000000000000000001
10000001000000000000000000000001
1000000D000000000000000000000001
10000001000000000000000000000001
10000000000000000000000000000001
11111111111111111111111111111111