NO ./asset/texture/txtr1.xpm
SO ./asset/texture/txtr4.xpm
WE ./asset/texture/txtr10.xpm
EA ./asset/texture/txtr19.xpm

F 132,192,17
C 195,224,244

        1111111111111111111111111
        1000000000110000000000001
        10W1000001110000000000001
        1001000000000000000000001
111111111011000001110000000100001
100000000011000001110111110111111
11110111111111011100000010001
11111111111111111111111110111
                                
11111111111111111111111111111
11110111111111011101010010001
11000000110101011100000010001
10000000000000001100000010001
10000000000000001101010010011
110000011101010111110111100111
11110111 1110101 101111010001
11111111 1111111 111111111111