NO ./assets/texture/txtr1.xpm
SO ./assets/texture/txtr28.xpm
WE ./assets/texture/txtr10.xpm
EA ./assets/texture/txtr19.xpm

F 132,192,17
C 195,224,244

        1111111111111111111111111
        1000000000110000000000001
        1001000001110000000000001
        1001000000000000000000001
111111111011000001110000000100001
10000000001100000111D11111D111111
11110111111101011100000010001
111111111111D11111111111111111
           101
           101
           101
111111111111D1111111111111111111
10000000000000000000000000000001
10000001000000000000000000000001
1000000D000000000000000000000001
10000001000000000E00000000000001
10000000000000000000000000000001
11111111111111111111111111111111